1111111111111
1C0100E000001
1001000000001
1C00000000001
1000111111001
1C001100C0001
1000110000001
1C001100C0001
1000110000001
1P001100C0001
1111111111111