NO ./tex/north.xpm
SO ./tex/south.xpm
WE ./tex/west.xpm
EA ./tex/east.xpm
F 220,100,0
C 225,30,0

         11111111
         10000001
         10000001
11111111110000001111111111
10000000000000000000000001
10000000000000000000000001
10000N00000000000000000001
10000000000000000000000001
10000000000000000000000001
11111111110000001111111111
         10000001
         10000001
         11111111
